111111111111111111111111111111111
100000000011000000000000100011111
101100000111000000000000100011111
100100000000000000000000100011111
111111111011000001110000000000001
100000000011000001110111100011111
11110111111111011100000010001
11110111111111011101010010001
11000000110101011100000011001
10000000000000001100000011N01
10000000000000001101010010001
1100000111010101111101111000111
11110111 1110101 101111010001
11111111 1111111 111111111111