F 53,41,34
EA textures/matrixEA.xpm
SO textures/matrixSO.xpm
C 100,100,100
WE textures/matrixWE.xpm
NO textures/matrixNO.xpm


111111111111111111111111111111111
100000000011000000000000100000001
101100000111000000000000100001001
100100000000000000000000100000001
111111111011000001110000000000001
10000000001100000111011110000N001
111101111111110111000000110011111
111101111111110111010100110001
110000001101010111000001110001
100000000000000011000000110001
10000000000000001101010011001
1100000111010101111101111100111
11110111 1110101 101111011001
11111111 1111111 111111111111