EA textures/matrixEA.xpm
SO textures/matrixSO.xpm
WE textures/matrixWE.xpm
NO textures/matrixNO.xpm

C 0, 0, 0
F 200, 100, 50


1111111111
1100100001
1000000101
1000000001
1000000001
1100S0011
1000000001
1000000001
1001010001
1111111111