11111111111111111111
11001000001100000111
11001000001100000111
11001000001100000111
11001000001100000111
1100100000100000111
1100100000100000111
1100100000100000111
1100100000100000111
11111111111111111111