EA textures/matrixEA.xpm
SO textures/matrixSO.xpm
WE textures/matrixWE.xpm
NO textures/matrixNO.xpm

C 135, 206, 235
F 0, 0, 0


11111111111111111111
11001000001100000111
11001000001100000111
11001000001100000111
11001000001100000111
1100100000100000111
1100100000100000111
110010000N100000111
1100100000100000111
11111111111111111111